4 4 4 4 4 4 4 4 4 4 4 4 4 4 4 4 4 4 4 4 4 4 4 4 4 4 4 4 4 4 4 4 4 4 4 4 4 4 4 4 4 4 4 4 4 4 4 4 4 4
4 4 4 4 4 4 4 4 4 4 4 4 4 4 4 4 4 4 4 4 4 4 4 4 4 4 4 4 4 4 4 4 4 4 4 4 4 4 4 4 4 4 4 4 4 4 4 4 4 4
4 4 4 4 4 4 4 4 4 4 4 4 4 4 4 4 4 4 4 4 4 4 4 4 4 4 4 4 4 4 4 4 4 4 4 4 4 4 4 4 4 4 4 4 4 4 4 4 4 4
4 4 4 4 4 4 4 4 4 4 4 4 4 4 4 4 4 4 4 4 4 4 4 4 4 4 4 4 4 4 4 4 4 4 4 4 4 4 4 4 4 4 4 4 4 4 4 4 4 4
4 4 2 2 2 2 2 2 2 2 2 2 2 2 2 2 2 2 2 2 2 2 2 2 2 2 2 2 2 2 2 2 2 4 4 4 4 4 4 4 4 4 4 4 4 4 4 4 4 4
4 4 2 5 5 5 5 5 5 5 5 5 5 5 5 5 5 5 5 5 5 5 5 5 2 5 5 5 5 5 5 5 2 4 4 4 4 4 4 4 4 4 4 4 4 4 4 4 4 4
4 4 2 5 2 2 2 2 2 2 2 2 2 2 2 2 2 2 2 2 2 2 2 5 2 2 2 5 2 2 2 5 2 4 0 0 0 0 0 0 0 0 0 0 0 0 0 0 0 4
4 4 2 5 2 5 5 5 5 5 5 5 5 5 5 5 5 5 5 5 5 5 2 5 5 5 2 5 5 5 2 5 2 4 0 0 0 0 0 0 0 0 0 0 0 0 0 0 0 4
4 4 2 5 2 5 2 2 2 2 2 2 2 2 2 2 2 2 2 2 2 5 2 2 2 5 2 2 2 2 2 5 2 4 0 0 0 0 0 0 0 0 0 0 0 0 0 0 0 4
4 4 2 5 2 5 5 5 5 5 5 5 5 5 5 5 2 5 5 5 5 5 5 5 2 5 5 5 5 5 5 5 2 4 0 0 0 0 0 0 0 0 0 0 0 0 0 0 0 4
4 4 2 5 2 5 2 2 2 2 2 2 2 2 2 5 2 2 2 2 2 2 2 2 2 2 2 2 2 2 2 5 2 4 0 0 0 0 0 0 0 0 0 0 0 0 0 0 0 4
4 4 2 5 2 5 5 5 2 5 5 5 5 5 2 5 5 5 5 5 5 5 5 5 5 5 5 5 5 5 2 5 2 4 0 0 0 0 0 0 0 0 0 0 0 0 0 0 0 4
4 4 2 5 2 2 2 5 2 5 2 5 2 2 2 2 2 2 2 2 2 2 2 2 2 2 2 5 2 2 2 5 2 4 0 0 0 0 0 0 0 0 0 0 0 0 0 0 0 4
4 4 2 5 2 5 2 5 2 5 2 5 5 5 5 5 5 5 5 5 5 5 5 5 5 5 2 5 5 5 5 5 2 4 4 4 4 4 4 4 0 0 0 4 4 4 4 4 4 4
4 4 2 5 2 5 2 5 2 5 2 2 2 2 2 2 2 2 2 2 2 2 2 2 2 5 2 2 2 2 2 2 2 4 4 4 4 4 4 4 0 0 0 4 4 4 4 4 4 4
4 4 2 5 2 5 2 5 2 5 2 5 5 5 5 5 5 5 5 5 5 5 5 5 2 5 5 5 5 5 5 5 2 4 4 4 4 4 4 4 0 0 0 4 4 4 4 4 4 4
4 4 2 5 2 5 2 5 2 5 2 5 2 2 2 2 2 2 2 2 2 2 2 5 2 5 2 2 2 2 2 5 2 4 4 4 4 4 4 4 0 0 0 4 4 4 4 4 4 4
4 4 2 5 2 5 5 5 2 5 5 5 2 5 5 5 5 5 5 5 5 5 2 5 2 5 2 5 5 5 2 5 2 4 4 4 4 4 4 4 0 0 0 4 4 4 4 4 4 4
4 4 2 5 2 5 2 2 2 2 2 2 2 2 2 5 2 2 2 2 2 5 2 5 2 5 2 5 2 5 2 5 2 4 4 4 4 4 4 4 0 0 0 4 4 4 4 4 4 4
4 4 2 5 2 5 2 5 5 5 5 5 5 5 2 5 5 5 5 5 2 5 5 5 2 5 2 5 2 5 2 5 2 4 4 4 4 4 4 4 0 0 0 4 4 4 4 4 4 4
4 4 2 5 2 5 2 5 2 2 2 2 2 5 2 2 2 2 2 2 2 2 2 2 2 5 2 5 2 5 2 5 2 4 4 4 4 4 4 4 0 0 0 4 4 4 4 4 4 4
4 4 2 5 2 5 5 5 2 5 5 5 5 5 2 2 2 2 2 2 2 2 2 2 2 5 5 5 2 5 5 5 5 0 0 0 0 0 0 0 0 0 0 0 0 0 0 0 4 4
4 4 2 5 2 2 2 2 2 5 2 2 2 2 2 2 2 2 2 2 2 2 2 2 2 2 2 2 2 2 2 2 2 4 4 0 0 0 0 0 0 0 0 0 0 0 0 0 4 4
4 4 6 1 6 1 1 1 1 1 1 1 1 1 1 1 6 1 1 1 1 1 1 1 1 1 1 1 1 1 1 1 1 0 0 0 0 0 0 0 0 0 0 0 0 0 0 0 4 4
4 4 6 1 6 1 6 6 6 6 6 6 6 6 6 6 6 1 6 6 6 6 6 6 6 6 6 6 6 6 6 6 6 4 4 4 4 4 4 4 0 0 0 4 4 4 4 4 4 4
4 4 6 1 6 1 1 1 1 1 1 1 1 1 1 1 6 1 6 1 1 1 6 1 1 1 1 1 1 1 6 1 6 4 4 4 4 4 4 4 0 0 0 4 4 4 4 4 4 4
4 4 6 1 6 6 6 6 6 6 6 1 6 6 6 6 6 1 6 6 6 1 6 1 6 6 6 1 6 1 6 1 6 4 4 4 4 4 4 4 0 0 0 4 4 4 4 4 4 4
4 4 6 1 1 1 1 1 1 1 6 1 6 1 1 1 6 1 6 1 1 1 6 1 6 1 6 1 6 1 6 1 6 4 4 4 4 4 4 4 0 0 0 4 4 4 4 4 4 4
4 4 6 1 6 6 6 6 6 1 6 6 6 1 6 1 6 1 6 1 6 6 6 1 6 1 6 1 6 1 6 1 6 4 4 4 4 4 4 4 0 0 0 4 4 4 4 4 4 4
4 4 6 1 1 1 1 1 6 1 1 1 1 1 6 1 6 1 6 1 1 1 6 1 1 1 6 1 6 1 1 1 6 4 4 4 4 4 4 4 0 0 0 4 4 4 4 4 4 4
4 4 6 6 6 6 6 1 6 6 6 6 6 6 6 1 6 1 6 6 6 1 6 6 6 1 6 1 6 6 6 1 6 4 4 4 4 4 4 4 0 0 0 4 4 4 4 4 4 4
4 4 6 1 1 1 6 1 1 1 6 1 1 1 6 1 6 1 1 1 6 1 1 1 1 1 6 1 6 1 1 1 6 4 4 4 4 4 4 4 0 0 0 4 4 4 4 4 4 4
4 4 6 1 6 1 6 6 6 1 6 1 6 1 6 1 6 6 6 1 6 1 6 6 6 6 6 1 6 1 6 6 6 4 4 4 4 4 4 4 0 0 0 4 4 4 4 4 4 4
4 4 6 1 6 1 1 1 6 1 6 1 6 1 6 1 1 1 6 1 6 1 1 1 1 1 6 1 6 1 6 1 6 4 4 4 4 4 4 4 0 0 0 4 4 4 4 4 4 4
4 4 6 1 6 6 6 1 6 1 6 1 6 1 6 6 6 1 6 1 6 6 6 6 6 1 6 1 6 1 6 1 6 1 3 3 3 3 3 3 3 3 3 3 3 3 3 3 3 4
4 4 6 1 6 1 1 1 6 1 6 1 6 1 1 1 1 1 6 1 1 1 1 1 6 1 6 1 6 1 6 1 6 1 3 3 3 3 3 3 3 3 3 3 3 3 3 3 3 4
4 4 6 1 6 1 6 6 6 1 6 1 6 6 6 6 6 1 6 6 6 6 6 1 6 1 6 1 6 1 6 1 6 1 3 3 3 3 3 3 3 3 3 3 3 3 3 3 3 4
4 4 6 1 6 1 1 1 6 1 6 1 6 1 1 1 6 1 6 1 1 1 6 1 6 1 6 1 6 1 6 1 6 1 3 3 3 3 3 3 3 3 3 3 3 3 3 3 3 4
4 4 6 1 6 6 6 6 6 1 6 1 6 1 6 1 6 1 6 1 6 6 6 1 6 1 6 1 6 1 6 1 6 1 3 3 3 3 3 3 3 3 3 3 3 3 3 3 3 4
4 4 6 1 1 1 1 1 1 1 6 1 6 1 6 1 6 1 6 1 1 1 6 1 6 1 6 1 6 1 1 1 6 1 3 3 3 3 3 3 3 3 3 3 3 3 3 3 3 4
4 4 6 1 6 6 6 6 6 6 6 1 6 1 6 6 6 1 6 6 6 1 6 1 6 6 6 1 6 6 6 6 6 1 3 3 3 3 3 3 3 3 3 3 3 3 3 3 3 4
4 4 6 1 6 1 1 1 1 1 6 1 6 1 1 1 1 1 1 1 1 1 6 1 1 1 6 1 1 1 1 1 6 1 3 3 3 3 3 3 3 3 3 3 3 3 3 3 3 4
4 4 6 1 6 6 6 6 6 1 6 1 6 6 6 6 6 6 6 6 6 6 6 6 6 1 6 6 6 6 6 1 6 1 3 3 3 3 3 3 3 3 3 3 3 3 3 3 3 4
4 4 6 1 1 1 1 1 1 1 6 1 1 1 1 1 1 1 1 1 1 1 1 1 1 1 1 1 1 1 1 1 6 1 3 3 3 3 3 3 3 3 3 3 3 3 3 3 3 4
4 4 6 6 6 6 6 6 6 6 6 6 6 6 6 6 6 6 6 6 6 6 6 6 6 6 6 6 6 6 6 6 6 1 1 1 1 1 1 1 1 1 1 1 1 1 1 1 1 4
4 4 4 4 4 4 4 4 4 4 4 4 4 4 4 4 4 4 4 4 4 4 4 4 4 4 4 4 4 4 4 4 4 4 4 4 4 4 4 4 4 4 4 4 4 4 4 4 4 4
4 4 4 4 4 4 4 4 4 4 4 4 4 4 4 4 4 4 4 4 4 4 4 4 4 4 4 4 4 4 4 4 4 4 4 4 4 4 4 4 4 4 4 4 4 4 4 4 4 4
4 4 4 4 4 4 4 4 4 4 4 4 4 4 4 4 4 4 4 4 4 4 4 4 4 4 4 4 4 4 4 4 4 4 4 4 4 4 4 4 4 4 4 4 4 4 4 4 4 4
4 4 4 4 4 4 4 4 4 4 4 4 4 4 4 4 4 4 4 4 4 4 4 4 4 4 4 4 4 4 4 4 4 4 4 4 4 4 4 4 4 4 4 4 4 4 4 4 4 4
4 4 4 4 4 4 4 4 4 4 4 4 4 4 4 4 4 4 4 4 4 4 4 4 4 4 4 4 4 4 4 4 4 4 4 4 4 4 4 4 4 4 4 4 4 4 4 4 4 4